//Enemy{e0,...e4}|Ufo{u},x,y,direction(-1left.1right);
//first column
//Q
e3,0,0,1
e3,0,1,1
e3,0,2,1
e3,0,3,1
e3,0,4,1
e3,1,0,1
e3,2,0,1
e3,3,0,1
e3,3,1,1
e3,3,2,1
e3,3,3,1
e3,3,4,1
e3,1,4,1
e3,2,4,1
e3,4,5,1
//t
e3,6,1,1
e3,7,0,1
e3,7,1,1
e3,7,2,1
e3,7,3,1
e3,7,4,1
e3,8,1,1
